OOOOOOOOOOOOOOOOOOOOOOOO
O 2    XXXXXXX    XXX  O
O XXXX         XX     XO
O X XX OOOOXX XX  XXX  O
O   XX           XXX  XO
OX XX  OOOOX XXX XXX XXO
OX    XOXXX  X    X  XXO
OXXXX    XX XX XX   XXXO
OXXXXXXX        1 XXXXXO
OOOOOOOOOOOOOOOOOOOOOOOO

-1 0 #
1 0 #
