XXXXXXXXXXXXXXXXX
X 2   XXXX      X
XXX XX  O  XXXXXX
XXX    XOX      X
XXXXXX     XXXX X
XXXX   XXX    X X
X    X     XX   X
X XX   XXXX   XXX
X    X  XX  X   X
XXXXXXX  X XXXXXX
XX   XX  X      X
X  X   X   XXXX X
XXXXX XXXX      X
X      OOO XX X X
XXXXXX        1 X
XXXXXXXXXXXXXXXXX

-1 0 #
1 0 #
