OOOOOOXXXXXXXXXX
O2OOOO         X
O      XXXXX XXX
OOOOOOXXXXXX XXX
X    XXXX    XXX
XXXX      XX XXX
XXXXX XXXXXX XXX
X              X
XXXXX XXXXX XXXX
XXXXX       XXXX
XXXX  XX XXXXXXX
XXXXX         XX
XXXXXXXXXXXX XXX
X            XXX
X XXXX XX XXXXXX
X XXXX XX XXXXXX
X        1  XXXX
XXXXXXXXXXXXXXXX


0 1 #
1 0 #
