OOOOOOcOOOOOO
O 1   O     O
O O O O O O O
O        S  O
OOO O . O OOO
O  S      2 O
O O O O O O O
O     O     O
OOOOOOOOOOOOO

0 1 # player 1 initial direction
0 -1 # player 2 initial direction
3 #
