XXXXXXXXXXXXXX
X1         X X
X X XX XXX X X
X X X  X X   X
X XXXX.X X XXX
X            X
XXXX XXXXXXXXX
X           2X
XXXXXXXXXXXXXX

1 0#
-1 0#
4 #
