XXXXXXXXXXXXXXXXXXX
X2          XXX   X
XXXXXXX XXXXXXXXX X
XXX        X      X
XXXXXXXXXX   XX XXX
X          XX   XXX
XXXXXX XXXXXXXX XXX
X        1   XX XXX
XXXXXXXXXXXX    XXX
XXXXXXXXXXXXXXXXXXX

-1 0 #
1 0 #
