XXXXXXXXXXXXXXXXXXX
X2          XXX   X
XXXXXXX XXXX XXXX X
XXX        X  XX  X
XXXXXXXXX.   XX  XX
X          XX   XXX
XXXXXX XXXXX  XXXXX
X        1   XXXXXX
XXXXXXXXXXXXXXXXXXX

-1 0 #
1 0 #
