OOOOOOXXXOOOOOOO
O2        XXXXXO
OXXXX XXX     1O
O         XXXXXO
OOOOOOXXXOOOOOOO
