XXXXXXXXXXXXXX
X1         X X
X X XX XXX X X
X X X  X X   X
X XXXXXX X XXX
X            X
XXXX XXXXXXXXX
X           2X
XXXXXXXXXXXXXX
