XXXXXXXXXXXXXXXXX
X1          X   X
X X XXXXX X X X X
X X X     X   X X
X X X XXXXXXXXX X
X   X         X X
XXX X X XXXXX X X
X X X X X   X X X
X X     X X   X X
X XXXXX X XXXXX X
X       X X   X X
XXXXXXXXX X X XXX
X   X     X X X X
X X XXXXX X X X X
X X X     X X   X
X XXX XXXXX XXXXX
X              2X
XXXXXXXXXXXXXXXXX
