XXXXXXXXXXXXXXXXXXX
X2          XXX   X
XXXXXXX XXXX XXXX X
XXX        X  XX  X
XXXXXXXXXX   XX  XX
X          XX   XXX
XXXXXX XXXXX  XXXXX
X        1   XXXXXX
XXXXXXXXXXXXXXXXXXX
