OOOOOOXXXXXXXXXX
O2OOOO         X
O      XXXXX XXX
OOOOOOXXXXXX XXX
X    XXXX    XXX
XXXX      XX XXX
XXXXX XXXXXX XXX
X              X
XXXXX XXXXX XXXX
XXXXX       XXXX
XXXX  XX XXXXXXX
XXXXX         XX
XXXXXXXXXXXX XXX
XXX          XXX
XXXXXX XXXXXXXXX
XXXXXX XXXXXXXXX
XXXXX    1  XXXX
XXXXXXXXXXXXXXXX