XXXXXXXXXXXXXXXXXXXXXXXX
X                X     X
X XXXXXXXX XXXXX   XXX X
X X        XXXXXXX   X X
X XXXXXXXX XXXXXXXXX X X
X X    XXX        XX X X
X X XXXXXXXXXXXXX XX X X
X X XXXOOOOOOOOXX XX   X
X           OOOXX XXXX X
X XX XX OOO1OOOXX X    X
X XX X  O2OOOOOXX XXXX X
X XX X OO              X
X XX   OOOOOOOOX XXXXX X
X XX XXXXXXXXXXX X   X X
X XX         XXX XXX   X
X XXXXXXXXXX        XX X
X XXXXX   XX XXXXXXXXX X
X       X              X
XXXXXXXXXXXXXXXXXXXXXXXX
