OOOOOOOOOOOOOOOOOOOOOOOO
O 2    XXXXXXX    XXX  O
O XXXX         XX     XO
O X XX OOOOXX OO  XXX  O
O   XX OOOOX  OO XXX  XO
O  XX  OOOO  XXX XXX XXO
OX    XOXX  XX   XX  XXO
OXXXX      XXX XX   XXXO
OXXXXXXXXX      1 XXXXXO
OOOOOOOOOOOOOOOOOOOOOOOO