OOOOOOOOOOOO
O2  OO     O
O    OO    O
O          O
O    OO    O
O   OO    1O
OOOOOOOOOOOO