XXXXXXXXXXXXXXXXXX
X 1   XXXX X X X X
X   X XXXX X X X X
X          X X X X
X X              X
X X X XXXX X X   X
X X X XXXX   X 2 X
XXX              X
X   X XXXXX  XXXXX
X  XX XXXX  XXXXXX
XXXXXXXXXXXXXXXXXX
