XXXXXXXXXXXXXXXXXXXXXXXXX
X1        XXXX         2X
XXXX  XXXX    XXXX   XXXX
X          XX           X
XXXXXXXXXXXXXXXXXXXXXXXXX
